2 2 2 2 2 2 2 2 2 2 2 2 2 2 2 2 2 2 2 2 2 2 2 2 2 2 2 2 2 2 2 2 2 2 2 2 2 2 2 2 2 2 2 2 2 2 2 2 2
1 0 0 0 0 0 0 0 0 0 0 0 0 0 0 0 0 0 0 0 0 0 0 0 0 0 0 0 0 0 0 0 0 0 0 0 0 0 0 0 0 0 0 0 0 0 0 0 1
1 0 0 0 0 0 0 0 0 0 0 0 0 0 0 0 0 0 0 0 0 0 0 0 0 0 0 0 0 0 0 0 0 0 0 0 0 0 0 0 0 0 0 0 0 0 0 0 1
1 0 0 0 0 0 0 0 0 0 0 0 1 1 1 1 1 1 1 1 1 1 0 0 4 4 0 0 2 2 0 0 3 3 0 1 4 0 0 0 0 0 0 0 0 0 0 0 1
1 0 0 0 3 3 3 3 0 0 0 0 1 0 0 0 0 0 0 0 0 0 0 0 4 4 0 0 2 2 0 0 3 3 0 1 1 0 0 0 0 0 0 0 0 0 0 0 1
1 0 0 0 0 0 0 3 0 0 0 0 1 0 0 0 0 0 2 2 0 0 0 0 0 0 0 0 0 0 0 0 0 0 0 0 0 0 0 0 0 0 0 0 0 0 0 0 1
1 0 0 1 0 0 0 3 3 3 3 3 1 1 1 1 1 1 0 2 2 2 0 0 0 0 3 3 3 3 3 3 3 0 1 1 1 1 1 1 1 1 1 1 1 1 1 1 1
1 0 0 1 0 0 0 3 0 0 0 3 0 0 0 0 0 1 0 2 0 2 0 0 0 0 3 0 0 0 0 0 3 0 0 0 0 4 0 0 0 0 0 0 0 0 0 0 1
1 0 0 1 0 0 0 3 0 0 0 3 0 0 1 0 0 1 0 2 0 2 0 0 0 0 3 0 3 3 3 0 3 0 0 0 0 4 0 0 0 0 0 0 0 0 0 0 1
1 0 0 1 1 1 1 3 0 0 0 3 0 0 1 1 1 1 0 0 0 2 0 0 0 0 3 0 3 0 2 0 3 0 0 0 0 4 0 0 0 0 4 0 4 0 0 0 1
1 0 0 0 0 0 0 0 0 0 0 3 0 0 0 0 0 0 0 0 0 2 2 2 2 2 2 0 3 0 0 0 3 0 0 0 0 4 0 0 0 0 4 0 4 0 0 0 1
1 0 2 2 2 0 0 0 0 0 0 0 0 0 0 0 0 0 0 0 0 0 0 0 0 0 0 0 3 3 3 3 3 0 0 0 0 4 4 4 4 4 4 0 4 4 4 4 1
1 0 2 0 2 0 0 0 0 0 0 0 0 3 3 3 3 3 0 0 0 0 0 0 0 0 0 0 0 0 0 0 0 0 0 0 0 0 0 0 0 0 0 0 0 0 0 0 1
1 0 2 0 2 0 0 0 0 0 0 0 0 0 0 0 0 0 0 0 0 0 0 0 0 0 0 0 0 0 0 0 0 0 0 0 6 6 6 6 6 6 6 6 6 6 6 0 1
1 0 0 0 0 0 0 0 0 0 0 0 0 0 0 0 0 0 0 0 0 0 0 0 0 0 0 0 0 0 0 0 0 0 0 0 6 0 0 0 0 0 6 0 0 0 6 0 1
1 0 0 0 0 0 0 0 0 0 0 0 1 1 1 1 1 1 1 1 1 1 0 0 4 4 0 0 2 2 0 0 3 3 0 1 6 0 6 0 0 0 0 0 0 0 6 0 1
1 0 0 0 3 3 3 3 0 0 0 0 1 0 0 0 0 0 0 0 0 0 0 0 4 4 0 0 2 2 0 0 3 3 0 1 1 0 6 6 6 6 6 6 6 6 6 0 1
1 0 0 0 0 0 0 3 0 0 0 0 1 0 0 0 0 0 2 2 0 0 0 0 0 0 0 0 0 0 0 0 0 0 0 0 0 0 0 0 0 0 0 0 0 0 0 0 1
1 0 0 1 0 0 0 3 3 3 3 3 1 1 1 1 1 1 0 2 2 2 0 0 0 0 3 3 3 3 3 3 3 0 1 1 1 1 1 1 1 1 1 1 1 1 1 1 1
1 0 0 1 0 0 0 3 0 0 0 3 0 0 0 0 0 1 0 2 0 2 0 0 0 0 3 0 0 0 0 0 3 0 0 0 0 4 0 0 0 0 0 0 0 0 0 0 1
1 0 0 1 0 0 0 3 0 0 0 3 0 0 1 0 0 1 0 2 0 2 0 0 0 0 3 0 3 3 3 0 3 0 0 0 0 4 0 0 0 0 0 0 0 0 0 0 1
1 0 0 1 1 1 1 3 0 0 0 3 0 0 1 1 1 1 0 0 0 2 0 0 0 0 3 0 3 0 2 0 3 0 0 0 0 4 0 0 0 0 4 0 4 0 0 0 1
1 0 0 0 0 0 0 0 0 0 0 3 0 0 0 0 0 0 0 0 0 2 2 2 2 2 2 0 3 0 0 0 3 0 0 0 0 4 0 0 0 0 4 0 4 0 0 0 1
1 0 0 0 0 0 0 0 0 0 0 0 0 0 0 0 0 0 0 0 0 0 0 0 0 0 0 0 3 3 3 3 3 0 0 0 0 4 4 4 4 4 4 0 4 4 4 4 1
1 0 0 0 0 0 0 0 0 0 0 0 0 0 0 0 0 0 0 0 0 0 0 0 0 0 0 0 0 0 0 0 0 0 0 0 0 0 0 0 0 0 0 0 0 0 0 0 1
1 0 0 0 0 0 0 0 0 0 0 0 0 0 0 0 0 0 0 0 0 0 0 0 0 0 0 0 0 0 0 0 0 0 0 0 0 0 0 0 0 6 6 0 0 0 0 0 1
1 0 0 0 0 0 0 0 0 0 0 0 0 0 0 0 0 0 0 0 0 0 0 0 0 0 0 0 0 0 0 0 0 0 0 0 0 0 0 0 0 0 6 0 0 0 0 0 1
1 0 0 0 0 0 0 0 0 0 0 0 1 1 1 1 1 1 1 1 1 1 0 0 4 4 0 0 2 2 0 0 3 3 0 1 4 0 0 0 0 0 6 6 6 0 0 0 1
1 0 0 0 3 3 3 3 0 0 0 0 1 0 0 0 0 0 0 0 0 0 0 0 4 4 0 0 2 2 0 0 3 3 0 1 1 0 0 0 0 0 6 0 0 0 0 0 1
1 0 0 0 0 0 0 3 0 0 0 0 1 0 0 0 0 0 2 2 0 0 0 0 0 0 0 0 0 0 0 0 0 0 0 0 0 0 0 0 0 0 0 0 0 0 0 0 1
1 0 0 1 0 0 0 3 3 3 3 3 1 1 1 1 1 1 0 2 2 2 0 0 0 0 3 3 3 3 3 3 3 0 1 1 1 1 1 1 1 1 1 1 1 1 1 0 1
1 0 0 1 0 0 0 3 0 0 0 3 0 0 0 0 0 1 0 2 0 2 0 0 0 0 3 0 0 0 0 0 3 0 0 0 0 4 0 0 0 0 0 0 0 0 1 0 1
1 0 0 1 0 0 0 3 0 0 0 3 0 0 1 0 0 1 0 2 0 2 0 0 0 0 3 0 3 3 3 0 3 0 0 0 0 4 0 0 0 0 0 0 0 0 1 0 1
1 0 0 1 1 1 1 3 0 0 0 3 0 0 1 1 1 1 0 0 0 2 0 0 0 0 3 0 3 0 2 0 3 0 0 0 0 4 0 0 0 0 4 0 4 0 1 0 1
1 0 0 0 0 0 0 0 0 0 0 3 0 0 0 0 0 0 0 0 0 2 2 2 2 2 2 0 3 0 0 0 3 0 0 0 0 4 0 0 0 0 4 0 4 0 0 0 1
1 0 0 0 0 0 0 0 0 0 0 0 0 0 0 0 0 0 0 0 0 0 0 0 0 0 0 0 3 3 3 3 3 0 0 0 0 4 4 4 4 4 4 0 4 4 4 4 1
1 0 0 0 0 0 0 0 0 0 0 0 0 0 0 0 0 0 0 0 0 0 0 0 0 0 0 0 0 0 0 0 0 0 0 0 0 0 0 0 0 0 0 0 0 0 0 0 1
1 0 0 0 0 0 0 0 0 0 0 0 1 1 1 1 1 1 1 1 1 1 0 0 4 4 0 0 2 2 0 0 3 3 0 1 4 0 0 0 0 0 0 0 0 0 0 0 1
1 0 0 0 3 3 3 3 0 0 0 0 1 0 0 0 0 0 0 0 0 0 0 0 4 4 0 0 2 2 0 0 3 3 0 1 1 0 0 0 0 0 0 0 0 0 0 0 1
1 0 0 0 0 0 0 3 0 0 0 0 1 0 0 0 0 0 0 2 0 0 0 0 0 0 0 0 0 0 0 0 0 0 0 0 0 0 0 0 0 0 0 0 0 0 0 0 1
1 1 0 1 0 0 0 3 3 3 3 3 1 1 1 1 1 1 0 2 2 2 0 0 0 0 3 3 3 3 3 3 3 0 1 1 1 1 1 1 1 1 1 1 1 1 1 1 1
1 0 0 1 0 0 0 3 0 0 0 3 0 0 0 0 0 1 0 2 0 2 0 0 0 0 3 0 0 0 0 0 3 0 0 0 0 4 0 0 0 0 0 0 0 0 0 0 1
1 0 0 1 0 0 0 3 0 0 0 3 0 0 1 0 0 1 0 2 0 2 0 0 0 0 3 0 3 3 3 0 3 0 0 0 0 4 0 0 0 0 0 0 0 0 0 0 1
1 0 0 1 1 1 1 3 0 0 0 3 0 0 1 1 1 1 0 0 0 2 0 0 0 0 3 0 3 0 2 0 3 0 0 0 0 4 0 5 0 0 4 0 4 0 0 0 1
1 0 0 0 0 0 0 0 0 0 0 3 0 0 1 0 0 0 0 0 0 2 2 2 2 2 2 0 3 0 0 0 3 0 6 0 0 4 0 0 0 0 4 0 4 0 0 0 1
1 0 0 0 0 0 0 0 0 0 0 0 0 0 1 0 0 0 0 0 0 0 0 0 0 0 0 0 3 3 3 3 3 0 6 0 0 4 4 4 4 4 4 0 4 4 4 4 1
1 0 0 0 0 0 0 0 0 0 0 0 0 0 1 0 0 0 0 0 0 0 0 0 0 0 0 0 0 0 0 0 0 0 6 0 0 0 0 0 0 0 0 0 0 0 0 0 1
2 2 2 2 2 2 2 2 2 2 2 2 2 2 2 2 2 2 2 2 2 2 2 2 2 2 2 2 2 2 2 2 2 2 6 2 2 2 2 2 2 2 2 2 2 2 2 2 2
